001111222
000011222
003411122
033445552
333444555
633344558
667774588
666778888
666777788
..2.43...
..9.76...
7...9..4.
.2..1...6
.6...7.2.
.7..52...
2.1.....3
8...3...4
...8...17