001111222
000011222
003411122
033445552
333444555
633344558
667774588
666778888
666777788
.8...3...
1...7....
7....1...
5......7.
..3....2.
..8...6..
2.......3
8.7......
...8....7