000111222
000111222
000111222
333444555
333444555
333444555
666777888
666777888
666777888
.8...3...
1...7....
7....1...
5......7.
..3....2.
..8...6..
2.......3
8.7......
...8....7