000111222
000111222
000111222
333444555
333444555
333444555
666777888
666777888
666777888
.........
.........
.........
.........
.........
.........
.........
.........
.........