001111222
000011222
003411122
033445552
333444555
633344558
667774588
666778888
666777788
6..5...9.
1...7..5.
73....8..
.2..18...
.6.4.7...
.7.1.2..9
...7.9..3
.1.9...6.
3..8.4..7