001111222
000011222
003411122
033445552
333444555
633344558
667774588
666778888
666777788
..2....9.
.4.....5.
..5.9...2
5.4.....6
.....7...
.7.....3.
2.....4.3
.....5..4
..6.2..1.
